名前	カレーの食べ方
水川 大	ぶっかけ・混ぜ混ぜ派
柴田 菜々美	左ルー・せき止め派
児島 一哉	左ルー・混ぜ混ぜ派
牧瀬 慎之介	別盛り・別口派
篠田 勇太	ぶっかけ・混ぜ混ぜ派
萩原 将也	左ルー・ルー攻め派
及川 信輔	ぶっかけ・混ぜ混ぜ派
坂元 なつみ	左ルー・せき止め派
高樹 ケンイチ	別盛り・せき止め派
藤田 愛	ぶっかけ・せき止め派
菅原 長利	ぶっかけ・別口派
伊沢 夏空	左ルー・混ぜ混ぜ派
古田 瑠璃亜	左ルー・ルー攻め派
森井 一輝	ぶっかけ・せき止め派
坂本 なぎさ	奥ルー・別口派
首藤 基祐	手前ルー・別口派
手塚 寿々花	左ルー・ルー攻め派
岡村 優	右ルー・混ぜ混ぜ派
飯田 雅彦	奥ルー・ルー攻め派
池田 広司	右ルー・別口派
谷村 竜次	ぶっかけ・別口派
綾瀬 真一	左ルー・別口派
堀北 さやか	左ルー・混ぜ混ぜ派
岡田 なつみ	左ルー・せき止め派
倉田 芳正	右ルー・せき止め派
玉井 美希	左ルー・ルー攻め派
阿井 朝陽	左ルー・せき止め派
庄司 美里	ぶっかけ・混ぜ混ぜ派
中村 芳正	左ルー・せき止め派
栗山 雅之	ぶっかけ・せき止め派
風間 菜摘	左ルー・せき止め派
服部 麻由子	左ルー・せき止め派
前原 千夏	左ルー・せき止め派
中本 竜也	ぶっかけ・せき止め派
塚原 啓介	左ルー・せき止め派
牧瀬 恵子	左ルー・別口派
森川 洋	左ルー・混ぜ混ぜ派
大田 由宇	左ルー・せき止め派
井上 あおい	ぶっかけ・ルー攻め派
中川 明	右ルー・せき止め派
加藤 長利	右ルー・せき止め派
渡部 丈雄	手前ルー・別口派
工藤 鉄二	別盛り・別口派
徳田 美優	手前ルー・混ぜ混ぜ派
佐々木 あき	奥ルー・別口派
津田 宏	ぶっかけ・せき止め派
会田 莉沙	ぶっかけ・ルー攻め派
吉田 慢太郎	右ルー・ルー攻め派
安倍 照生	ぶっかけ・混ぜ混ぜ派
中野 まさし	左ルー・混ぜ混ぜ派
海老原 莉央	ぶっかけ・ルー攻め派
成瀬 陽介	ぶっかけ・ルー攻め派
古川 陽介	右ルー・混ぜ混ぜ派
多岐川 一輝	奥ルー・混ぜ混ぜ派
大津 陽子	ぶっかけ・ルー攻め派
小高 杏	奥ルー・ルー攻め派
今川 惇	左ルー・せき止め派
藤井 哲平	左ルー・混ぜ混ぜ派
渡辺 美和子	右ルー・別口派
横尾 広司	手前ルー・せき止め派
矢沢 仁	奥ルー・せき止め派
石田 樹里	ぶっかけ・ナン派
柏原 功補	別盛り・混ぜ混ぜ派
加藤 ヒロ	左ルー・別口派
富岡 だん吉	右ルー・混ぜ混ぜ派
対馬 禄郎	左ルー・せき止め派
秋田 ひろ子	左ルー・せき止め派
松川 瞬	右ルー・せき止め派
岩城 遥	奥ルー・別口派
高原 えみ	左ルー・ルー攻め派
少路 良介	左ルー・混ぜ混ぜ派
佐々木 あおい	左ルー・せき止め派
野原 美優	左ルー・混ぜ混ぜ派
小川 景子	ぶっかけ・せき止め派
上田 大樹	別盛り・せき止め派
横田 雅之	左ルー・せき止め派
小出 一徳	手前ルー・混ぜ混ぜ派
宇佐美 そら	別盛り・ルー攻め派
山中 みき	ぶっかけ・別口派
大森 秀樹	右ルー・せき止め派
片桐 良介	右ルー・混ぜ混ぜ派
木下 まみ	奥ルー・ルー攻め派
熊倉 光良	手前ルー・せき止め派
津川 薫	左ルー・せき止め派
落合 真希	左ルー・別口派
黒谷 有海	左ルー・別口派
藤沢 麻緒	手前ルー・混ぜ混ぜ派
満島 鉄洋	左ルー・ルー攻め派
杉浦 理紗	奥ルー・せき止め派
杉本 高史	左ルー・ルー攻め派
長田 昴	手前ルー・せき止め派
堀内 一代	右ルー・ルー攻め派
湯浅 まなみ	右ルー・せき止め派
森田 丈雄	左ルー・混ぜ混ぜ派
境 康文	左ルー・混ぜ混ぜ派
菅谷 育子	ぶっかけ・別口派
青木 雅之	左ルー・混ぜ混ぜ派
長崎 真帆	ぶっかけ・せき止め派
綾小路 公顕	ぶっかけ・せき止め派
小沼 晋也	ぶっかけ・ナン派
江原 精児	ぶっかけ・混ぜ混ぜ派
唐沢 花	左ルー・ナン派
木田 啓介	左ルー・混ぜ混ぜ派
山元 沙知絵	ぶっかけ・せき止め派
神木 友以乃	手前ルー・ルー攻め派
植田 まみ	ぶっかけ・ルー攻め派
尾崎 寿明	奥ルー・混ぜ混ぜ派
江原 ジョージ	左ルー・別口派
青木 恵美	奥ルー・ルー攻め派
奥山 光	左ルー・せき止め派
花田 法子	左ルー・ナン派
相原 しぼり	左ルー・せき止め派
鶴田 遥	別盛り・混ぜ混ぜ派
葛西 奈々	ぶっかけ・混ぜ混ぜ派
木戸 誠一	ぶっかけ・せき止め派
柴田 蒼甫	手前ルー・混ぜ混ぜ派
徳永 璃奈子	ぶっかけ・せき止め派
小森 洋介	奥ルー・せき止め派
若林 翔	左ルー・ナン派
阿井 ちえみ	左ルー・せき止め派
杉村 秀隆	手前ルー・せき止め派
榊原 ジョージ	ぶっかけ・混ぜ混ぜ派
畑中 法子	右ルー・混ぜ混ぜ派
本村 愛菜	手前ルー・ルー攻め派
本間 みき	左ルー・せき止め派
黒崎 さやか	左ルー・せき止め派
長谷 美咲	右ルー・せき止め派
森井 進	左ルー・混ぜ混ぜ派
宮部 直人	左ルー・混ぜ混ぜ派
野本 英嗣	ぶっかけ・せき止め派
坂本 友香	左ルー・ルー攻め派
大森 サンタマリア	奥ルー・ルー攻め派
筒井 知世	左ルー・せき止め派
武内 まさし	手前ルー・別口派
三村 詩織	左ルー・混ぜ混ぜ派
外山 利夫	別盛り・ルー攻め派
沢田 京子	奥ルー・せき止め派
池谷 きみまろ	ぶっかけ・せき止め派
神戸 陽子	奥ルー・せき止め派
木原 寛治	ぶっかけ・ルー攻め派
三村 妃里	ぶっかけ・ルー攻め派
片平 浩介	ぶっかけ・ルー攻め派
米田 賢二	左ルー・せき止め派
児島 ヒロ	別盛り・ルー攻め派
宮下 小雁	ぶっかけ・混ぜ混ぜ派
河内 芳正	別盛り・ナン派
井原 進	ぶっかけ・ルー攻め派
滝 真吾	左ルー・混ぜ混ぜ派
石塚 遥	別盛り・混ぜ混ぜ派
三浦 愛	ぶっかけ・ルー攻め派
大崎 恵梨香	右ルー・せき止め派
西島 未來	右ルー・せき止め派
辻 希	手前ルー・ルー攻め派
矢野 花緑	ぶっかけ・別口派
藤崎 美佐子	左ルー・別口派
重田 莉央	ぶっかけ・せき止め派
古山 未華子	左ルー・ルー攻め派
川原 綾女	奥ルー・せき止め派
大林 一	ぶっかけ・混ぜ混ぜ派
藤井 真悠子	手前ルー・せき止め派
沢井 遥	右ルー・ルー攻め派
三浦 めぐみ	奥ルー・ナン派
成田 耕司	ぶっかけ・ルー攻め派
長崎 恵子	ぶっかけ・せき止め派
三輪 信輔	奥ルー・せき止め派
野島 菜々美	ぶっかけ・せき止め派
木田 高史	右ルー・せき止め派
高崎 優	奥ルー・混ぜ混ぜ派
松原 奈々	左ルー・せき止め派
村井 華子	左ルー・ルー攻め派
寺岡 大	左ルー・ルー攻め派
島本 守	右ルー・せき止め派
千田 新太	手前ルー・混ぜ混ぜ派
庄司 夏希	左ルー・せき止め派
大後 満	ぶっかけ・混ぜ混ぜ派
泉 砂羽	ぶっかけ・せき止め派
清田 菜摘	奥ルー・ナン派
片山 明日	右ルー・混ぜ混ぜ派
丸田 まひる	ぶっかけ・混ぜ混ぜ派
塚原 満	左ルー・せき止め派
坂上 だん吉	ぶっかけ・別口派
山下 昌代	左ルー・混ぜ混ぜ派
神崎 ノブヒコ	別盛り・せき止め派
沖 はるか	左ルー・せき止め派
百瀬 豊	手前ルー・せき止め派
渋谷 春樹	左ルー・別口派
志村 ひろみ	ぶっかけ・ルー攻め派
富山 勇介	右ルー・混ぜ混ぜ派
筒井 麻由子	手前ルー・ルー攻め派
島田 勇太	奥ルー・ルー攻め派
役所 恵子	左ルー・ルー攻め派
原口 里穂	手前ルー・ルー攻め派
大沢 憲一	ぶっかけ・せき止め派
平井 恵子	左ルー・ルー攻め派
邑野 美希	右ルー・ルー攻め派
志賀 秀隆	左ルー・せき止め派
石坂 和之	ぶっかけ・ルー攻め派
浅利 敏和	ぶっかけ・ルー攻め派
柏原 竜也	右ルー・せき止め派
岡崎 公顕	左ルー・ルー攻め派
沖田 正義	ぶっかけ・ルー攻め派
大崎 克実	左ルー・ルー攻め派
山田 美佳	左ルー・せき止め派
沢田 七世	左ルー・別口派
杉下 俊二	右ルー・せき止め派
西沢 遥	ぶっかけ・ルー攻め派
末吉 京子	左ルー・ルー攻め派
鈴木 咲	左ルー・ルー攻め派
吉崎 智花	奥ルー・別口派
武内 サンタマリア	手前ルー・ルー攻め派
大久保 未來	ぶっかけ・せき止め派
飯野 獅童	右ルー・混ぜ混ぜ派
手塚 くるみ	奥ルー・せき止め派
佐古 染五郎	ぶっかけ・混ぜ混ぜ派
奈良 雅彦	ぶっかけ・混ぜ混ぜ派
下田 路子	奥ルー・せき止め派
加藤 だん吉	奥ルー・別口派
北原 裕次郎	ぶっかけ・別口派
大浦 弘也	ぶっかけ・混ぜ混ぜ派
相原 瞬	右ルー・混ぜ混ぜ派
村山 早織	奥ルー・混ぜ混ぜ派
依田 砂羽	奥ルー・別口派
沢田 たかお	左ルー・別口派
山城 賢二	奥ルー・混ぜ混ぜ派
貫地谷 怜奈	左ルー・せき止め派
小室 秀隆	奥ルー・ルー攻め派
中根 建	ぶっかけ・混ぜ混ぜ派
宮原 ケンイチ	左ルー・せき止め派
対馬 明	左ルー・別口派
大内 璃奈子	ぶっかけ・ルー攻め派
脇田 涼	別盛り・ルー攻め派
パンツェッタ 利夫	左ルー・混ぜ混ぜ派
藤野 仁晶	ぶっかけ・せき止め派
松村 ケンイチ	右ルー・別口派
野崎 翔	奥ルー・ナン派
立川 鉄二	ぶっかけ・混ぜ混ぜ派
福永 恭子	左ルー・ナン派
神崎 エリカ	手前ルー・別口派
三船 夏希	左ルー・混ぜ混ぜ派
山元 郁恵	奥ルー・混ぜ混ぜ派
金城 さとみ	ぶっかけ・ナン派
蛍原 徹平	左ルー・ルー攻め派
岸田 信輔	右ルー・別口派
阿部 璃奈子	ぶっかけ・ナン派
土屋 豊	ぶっかけ・せき止め派
富岡 雅功	ぶっかけ・ルー攻め派
志村 哲平	ぶっかけ・混ぜ混ぜ派
塚原 輝信	左ルー・別口派
神保 一代	ぶっかけ・せき止め派
長野 基祐	右ルー・ルー攻め派
角 満	左ルー・せき止め派
安井 美紀	ぶっかけ・混ぜ混ぜ派
大塚 綾	奥ルー・ルー攻め派
森井 照生	手前ルー・混ぜ混ぜ派
稲田 しほり	右ルー・せき止め派
岩下 将也	奥ルー・せき止め派
染谷 染五郎	ぶっかけ・せき止め派
西沢 明	ぶっかけ・別口派
岡田 美嘉	ぶっかけ・せき止め派
大坪 俊二	右ルー・せき止め派
小幡 寿々花	右ルー・混ぜ混ぜ派
田淵 沙知絵	ぶっかけ・混ぜ混ぜ派
湊 由宇	奥ルー・せき止め派
西田 聡	ぶっかけ・別口派
沢村 惇	左ルー・別口派
竹下 竜也	左ルー・ルー攻め派
山崎 薫	右ルー・別口派
森口 右京	左ルー・せき止め派
小西 千佳子	右ルー・混ぜ混ぜ派
金井 なつみ	ぶっかけ・ナン派
菅原 光臣	右ルー・混ぜ混ぜ派
村木 拓郎	左ルー・ルー攻め派
古田 一徳	左ルー・ルー攻め派
川村 みゆき	左ルー・ルー攻め派
高柳 菜々美	左ルー・ルー攻め派
田中 南朋	右ルー・混ぜ混ぜ派
国分 美佐	左ルー・せき止め派
ユースケ 七世	奥ルー・せき止め派
土井 さやか	奥ルー・混ぜ混ぜ派
児島 雅彦	左ルー・別口派
本田 怜奈	奥ルー・別口派
藤山 花	ぶっかけ・ルー攻め派
山村 亮介	右ルー・ルー攻め派
北条 樹里	奥ルー・別口派
高梨 茜	左ルー・ルー攻め派
成田 恵梨香	右ルー・ルー攻め派
山田 一徳	左ルー・ルー攻め派
松山 一恵	ぶっかけ・せき止め派
松谷 徹	ぶっかけ・ルー攻め派
浜 俊介	左ルー・ルー攻め派
堀江 晃司	奥ルー・ルー攻め派
黒崎 有海	右ルー・混ぜ混ぜ派
本山 恵梨香	ぶっかけ・混ぜ混ぜ派
荒井 豊	ぶっかけ・別口派
砂川 亮	手前ルー・せき止め派
三沢 真帆	奥ルー・別口派
佐久間 恵梨香	右ルー・せき止め派
松岡 晴臣	ぶっかけ・混ぜ混ぜ派
小笠原 光	左ルー・せき止め派
塩見 右京	ぶっかけ・ルー攻め派
前川 蒼甫	左ルー・混ぜ混ぜ派
白井 新太	左ルー・ナン派
渋谷 マサカズ	左ルー・別口派
多部 守	右ルー・別口派
川口 フミヤ	左ルー・混ぜ混ぜ派
根岸 まなみ	右ルー・ナン派
平松 聖陽	左ルー・ナン派
高木 マサカズ	手前ルー・ナン派
福士 恵美	左ルー・せき止め派
余 真一	奥ルー・別口派
坂本 米蔵	手前ルー・せき止め派
勝田 茂樹	右ルー・混ぜ混ぜ派
有田 りえ	左ルー・別口派
大倉 美智子	奥ルー・せき止め派
畠山 かおり	ぶっかけ・せき止め派
高畑 啓介	奥ルー・ナン派
曽我 倫子	ぶっかけ・混ぜ混ぜ派
宮原 華子	別盛り・別口派
矢野 あや子	ぶっかけ・ルー攻め派
園田 浩正	手前ルー・せき止め派
遠山 美咲	右ルー・混ぜ混ぜ派
飯田 光	ぶっかけ・ルー攻め派
宮城 真奈美	手前ルー・ナン派
永瀬 ひかり	左ルー・せき止め派
高梨 莉沙	左ルー・せき止め派
北原 結子	ぶっかけ・せき止め派
椎名 丈雄	手前ルー・せき止め派
松浦 涼子	手前ルー・ルー攻め派
西村 隆博	左ルー・せき止め派
狩野 恵子	左ルー・ルー攻め派
大野 寿々花	右ルー・せき止め派
小原 沙知絵	左ルー・別口派
有田 華子	左ルー・ルー攻め派
三浦 鉄二	左ルー・ルー攻め派
塩見 小百合	ぶっかけ・ルー攻め派
萩原 広之	左ルー・せき止め派
勝地 祐一	奥ルー・別口派
藤村 一代	左ルー・混ぜ混ぜ派
伊東 長利	手前ルー・ルー攻め派
田村 法嗣	左ルー・せき止め派
小口 さやか	左ルー・混ぜ混ぜ派
松下 一	左ルー・別口派
広川 一代	ぶっかけ・せき止め派
長谷 憲一	奥ルー・ルー攻め派
平松 優	ぶっかけ・混ぜ混ぜ派
坂本 さとみ	左ルー・ナン派
森永 直人	右ルー・ルー攻め派
長瀬 真一	左ルー・混ぜ混ぜ派
石原 由宇	右ルー・ルー攻め派
米沢 雅之	ぶっかけ・ルー攻め派
貫地谷 礼子	右ルー・せき止め派
菅谷 晋也	ぶっかけ・ナン派
高沢 啓介	手前ルー・別口派
波多野 芽以	左ルー・せき止め派
宇都宮 光博	左ルー・せき止め派
平野 貴美子	手前ルー・せき止め派
川原 きみまろ	奥ルー・ルー攻め派
堀田 しぼり	左ルー・ルー攻め派
千田 佳乃	左ルー・せき止め派
細川 聡	ぶっかけ・混ぜ混ぜ派
畑 玲那	ぶっかけ・せき止め派
梅沢 はじめ	ぶっかけ・ルー攻め派
二宮 賢治	右ルー・せき止め派
明石 璃奈子	別盛り・せき止め派
細井 夏空	手前ルー・混ぜ混ぜ派
仲村 法嗣	別盛り・ルー攻め派
滝沢 鉄二	左ルー・ルー攻め派
菅野 直人	左ルー・混ぜ混ぜ派
沢村 はるみ	ぶっかけ・せき止め派
町田 友也	ぶっかけ・ナン派
関 詩織	左ルー・混ぜ混ぜ派
澤田 祐基	ぶっかけ・混ぜ混ぜ派
井沢 雅彦	別盛り・混ぜ混ぜ派
塚本 剛基	左ルー・ルー攻め派
北山 芳正	別盛り・別口派
工藤 隼士	左ルー・混ぜ混ぜ派
菊地 ヒロ	手前ルー・せき止め派
永井 洋介	ぶっかけ・別口派
島袋 めぐみ	手前ルー・別口派
今川 妃里	ぶっかけ・ルー攻め派
永井 みき	ぶっかけ・せき止め派
植田 ひとり	左ルー・せき止め派
柴山 瞳	別盛り・ルー攻め派
飛田 小百合	右ルー・せき止め派
武井 陽子	ぶっかけ・せき止め派
河野 美佐	別盛り・せき止め派
篠崎 めぐみ	左ルー・混ぜ混ぜ派
川添 ヒカル	左ルー・混ぜ混ぜ派
対馬 博之	ぶっかけ・せき止め派
大和田 京子	ぶっかけ・別口派
酒井 しぼり	ぶっかけ・せき止め派
岩永 千佳子	奥ルー・混ぜ混ぜ派
鳥居 努	ぶっかけ・せき止め派
美木 理紗	ぶっかけ・ルー攻め派
酒井 さやか	左ルー・ルー攻め派
日野 翔子	奥ルー・ナン派
勝地 なつみ	手前ルー・せき止め派
相原 宏	左ルー・別口派
大下 咲	左ルー・せき止め派
役所 璃子	左ルー・混ぜ混ぜ派
森田 啓介	左ルー・混ぜ混ぜ派
柏木 樹里	ぶっかけ・混ぜ混ぜ派
堀越 雅彦	左ルー・混ぜ混ぜ派
五大 夏希	奥ルー・別口派
小幡 達士	左ルー・混ぜ混ぜ派
柳沢 努	左ルー・せき止め派
有田 健	ぶっかけ・混ぜ混ぜ派
吉本 淳	ぶっかけ・混ぜ混ぜ派
山根 敦	右ルー・ルー攻め派
水野 瞬	ぶっかけ・ナン派
沢田 真奈美	奥ルー・ルー攻め派
沢村 マサカズ	手前ルー・ルー攻め派
石倉 かおり	奥ルー・混ぜ混ぜ派
山田 博明	奥ルー・せき止め派
大竹 一恵	ぶっかけ・ルー攻め派
宮野 優	右ルー・せき止め派
松沢 大樹	左ルー・せき止め派
岩下 菜々美	ぶっかけ・ルー攻め派
相沢 進	ぶっかけ・ナン派
正木 メイサ	右ルー・別口派
浅利 かおり	奥ルー・せき止め派
竹原 正義	左ルー・ルー攻め派
河西 努	奥ルー・別口派
井沢 長利	右ルー・せき止め派
玉井 輝信	ぶっかけ・せき止め派
浦田 美幸	左ルー・せき止め派
岡崎 真悠子	左ルー・ルー攻め派
芳賀 耕司	手前ルー・ルー攻め派
菅原 丈雄	左ルー・ルー攻め派
神田 未華子	奥ルー・混ぜ混ぜ派
岸部 桃子	ぶっかけ・ルー攻め派
豊島 咲	右ルー・別口派
塚本 れいな	別盛り・混ぜ混ぜ派
畑 優一	手前ルー・せき止め派
浅田 圭	手前ルー・せき止め派
西本 マサカズ	左ルー・混ぜ混ぜ派
橋爪 真奈美	別盛り・別口派
河村 美智子	ぶっかけ・せき止め派
武田 佑	手前ルー・ルー攻め派
若杉 賢二	左ルー・ルー攻め派
竹田 莉緒	左ルー・ルー攻め派
阪口 六郎	手前ルー・せき止め派
深田 ひろみ	ぶっかけ・混ぜ混ぜ派
金井 薫	左ルー・せき止め派
安井 勇一	ぶっかけ・混ぜ混ぜ派
大泉 瞬	奥ルー・せき止め派
柳川 建	左ルー・混ぜ混ぜ派
池内 光洋	ぶっかけ・混ぜ混ぜ派
前島 美嘉	右ルー・ルー攻め派
水上 亮介	左ルー・別口派
長谷部 雄太	右ルー・せき止め派
風間 麻由子	左ルー・せき止め派
藤澤 直人	手前ルー・ルー攻め派
吉永 まさし	左ルー・混ぜ混ぜ派
志田 恵子	ぶっかけ・ルー攻め派
菊池 右京	ぶっかけ・混ぜ混ぜ派
佐川 莉緒	左ルー・せき止め派
高松 砂羽	ぶっかけ・せき止め派
松下 瞬	ぶっかけ・混ぜ混ぜ派
北山 知世	奥ルー・混ぜ混ぜ派
石野 勇一	左ルー・せき止め派
西川 正義	ぶっかけ・せき止め派
木村 新太	左ルー・混ぜ混ぜ派
高崎 薫	奥ルー・せき止め派
小峰 満	ぶっかけ・混ぜ混ぜ派
森山 正義	奥ルー・せき止め派
柄本 だん吉	左ルー・せき止め派
安座間 未來	右ルー・せき止め派
篠原 夏空	ぶっかけ・せき止め派
石井 早紀	ぶっかけ・別口派
大高 優	ぶっかけ・ナン派
百瀬 惇	右ルー・せき止め派
井田 一輝	左ルー・ナン派
池畑 まひる	左ルー・ルー攻め派
松居 真吾	奥ルー・せき止め派
前原 理紗	右ルー・ルー攻め派
渡部 明	右ルー・せき止め派
大河内 ヒカル	ぶっかけ・せき止め派
伊集院 沙知絵	左ルー・せき止め派
一青 昌代	ぶっかけ・せき止め派
正木 徹	右ルー・ルー攻め派
一青 崇史	左ルー・ナン派
寺本 亜希	奥ルー・ルー攻め派
武井 有海	奥ルー・ルー攻め派
松本 涼	ぶっかけ・ルー攻め派
久保 恵梨香	右ルー・別口派
和泉 薫	左ルー・ナン派
岩永 知史	左ルー・せき止め派
石崎 直人	左ルー・混ぜ混ぜ派
谷川 小雁	左ルー・別口派
小出 大五郎	左ルー・別口派
曽根 麻緒	手前ルー・混ぜ混ぜ派
松尾 三郎	奥ルー・せき止め派
石田 有海	ぶっかけ・ナン派
森山 哲平	左ルー・ナン派
豊田 精児	手前ルー・せき止め派
原 まなみ	ぶっかけ・別口派
横田 未來	奥ルー・混ぜ混ぜ派
山下 丈史	左ルー・ルー攻め派
岸田 なつみ	左ルー・ルー攻め派
五味 聡	ぶっかけ・せき止め派
国分 ヒロ	左ルー・混ぜ混ぜ派
片岡 ケンイチ	奥ルー・ナン派
森井 幸平	左ルー・混ぜ混ぜ派
須藤 麻由子	奥ルー・混ぜ混ぜ派
今井 はじめ	左ルー・せき止め派
千田 大五郎	左ルー・せき止め派
沖 遥	奥ルー・混ぜ混ぜ派
岩間 沙知絵	左ルー・ルー攻め派
相沢 夏空	左ルー・混ぜ混ぜ派
浜本 真一	ぶっかけ・ナン派
高柳 光良	ぶっかけ・ルー攻め派
横田 まみ	左ルー・混ぜ混ぜ派
貫地谷 美優	右ルー・別口派
河村 あさみ	奥ルー・別口派
桜井 南朋	奥ルー・ルー攻め派
石坂 茜	左ルー・せき止め派
進藤 亮	右ルー・混ぜ混ぜ派
岡 菜摘	右ルー・せき止め派
鹿賀 薫	右ルー・ルー攻め派
池上 あき	ぶっかけ・せき止め派
入江 幸子	左ルー・別口派
保坂 サンタマリア	左ルー・せき止め派
小笠原 陽子	ぶっかけ・混ぜ混ぜ派
満島 三郎	奥ルー・混ぜ混ぜ派
一青 育子	手前ルー・ルー攻め派
古賀 まなみ	左ルー・ルー攻め派
中田 米蔵	手前ルー・せき止め派
国分 ひとり	左ルー・混ぜ混ぜ派
牧野 和之	左ルー・別口派
今野 あい	ぶっかけ・せき止め派
今泉 ひろ子	左ルー・ルー攻め派
森永 蒼甫	ぶっかけ・ルー攻め派
玉木 芳正	手前ルー・せき止め派
進藤 有起哉	奥ルー・混ぜ混ぜ派
岩佐 剛基	左ルー・ルー攻め派
田村 恵子	ぶっかけ・せき止め派
上村 優	左ルー・混ぜ混ぜ派
菊地 千夏	奥ルー・ナン派
西沢 陽子	左ルー・せき止め派
矢作 翔太	奥ルー・混ぜ混ぜ派
金谷 ジローラモ	左ルー・混ぜ混ぜ派
吉田 努	ぶっかけ・別口派
本山 明宏	左ルー・別口派
寺尾 樹里	ぶっかけ・せき止め派
立花 聡	ぶっかけ・せき止め派
武田 徹	奥ルー・せき止め派
橋本 瑠璃亜	奥ルー・せき止め派
大坪 晴臣	左ルー・別口派
星野 獅童	ぶっかけ・混ぜ混ぜ派
北条 六郎	ぶっかけ・せき止め派
亀井 浩介	右ルー・ルー攻め派
島津 法子	奥ルー・別口派
大西 知世	別盛り・せき止め派
岩崎 完爾	手前ルー・せき止め派
黒谷 朝陽	ぶっかけ・別口派
長田 かおり	ぶっかけ・せき止め派
川越 守	奥ルー・ルー攻め派
新井 友香	右ルー・ルー攻め派
大槻 俊二	ぶっかけ・せき止め派
古山 瞬	ぶっかけ・混ぜ混ぜ派
越智 和久	奥ルー・ルー攻め派
藤崎 瞬	左ルー・混ぜ混ぜ派
志賀 陽介	手前ルー・せき止め派
川原 夏空	ぶっかけ・別口派
深井 みゆき	ぶっかけ・ナン派
村松 誠治	左ルー・せき止め派
伊藤 浩正	左ルー・混ぜ混ぜ派
守屋 光	ぶっかけ・混ぜ混ぜ派
川辺 遥	左ルー・ルー攻め派
玉田 優	奥ルー・ナン派
山内 綾女	左ルー・別口派
柳川 和香	右ルー・ルー攻め派
横尾 優	奥ルー・ルー攻め派
佐川 仁晶	ぶっかけ・ルー攻め派
安藤 薫	右ルー・ルー攻め派
新垣 未來	奥ルー・ルー攻め派
吉井 七世	ぶっかけ・ルー攻め派
安井 徹	ぶっかけ・ナン派
北沢 一樹	右ルー・せき止め派
岩本 剛基	左ルー・別口派
真鍋 貴美子	右ルー・別口派
高柳 妃里	右ルー・混ぜ混ぜ派
関口 光	ぶっかけ・混ぜ混ぜ派
立川 さやか	右ルー・ナン派
松山 克実	奥ルー・ナン派
緒方 和香	左ルー・別口派
末吉 恵望子	右ルー・混ぜ混ぜ派
金田 宏行	左ルー・別口派
石黒 コウ	奥ルー・別口派
藤島 広之	奥ルー・別口派
高野 竜也	左ルー・せき止め派
宮島 未華子	右ルー・混ぜ混ぜ派
小寺 智花	ぶっかけ・せき止め派
小泉 茜	別盛り・混ぜ混ぜ派
和泉 高史	奥ルー・せき止め派
加瀬 建	手前ルー・せき止め派
宮島 碧海	別盛り・せき止め派
五大 あおい	左ルー・せき止め派
近藤 悟志	ぶっかけ・別口派
真田 俊二	左ルー・別口派
西 賢二	ぶっかけ・別口派
田川 希	ぶっかけ・混ぜ混ぜ派
真田 愛梨	右ルー・混ぜ混ぜ派
北条 宏	右ルー・混ぜ混ぜ派
栗山 一	右ルー・せき止め派
佐々木 妃里	ぶっかけ・せき止め派
平田 充則	ぶっかけ・せき止め派
北村 ちえみ	左ルー・せき止め派
大田 さやか	右ルー・せき止め派
梅沢 杏	右ルー・ルー攻め派
今村 啓介	右ルー・ルー攻め派
金森 正敏	右ルー・ルー攻め派
沼田 恵美	手前ルー・ルー攻め派
山瀬 米蔵	ぶっかけ・せき止め派
藤本 亮	ぶっかけ・ナン派
役所 知世	ぶっかけ・せき止め派
平田 一	手前ルー・混ぜ混ぜ派
浅見 雅彦	右ルー・ナン派
野際 恵梨香	ぶっかけ・混ぜ混ぜ派
田上 惇	ぶっかけ・せき止め派
望月 優	左ルー・混ぜ混ぜ派
池上 まなみ	右ルー・別口派
堀田 美佳	ぶっかけ・別口派
紺野 隆博	右ルー・別口派
坂元 ひとみ	別盛り・混ぜ混ぜ派
浜野 勝久	奥ルー・せき止め派
三田 美和子	ぶっかけ・ルー攻め派
大谷 雅彦	右ルー・ルー攻め派
余 禄郎	奥ルー・混ぜ混ぜ派
飯野 明慶	ぶっかけ・せき止め派
片桐 守	手前ルー・ルー攻め派
塚田 美優	右ルー・せき止め派
高田 有海	左ルー・せき止め派
矢口 さやか	ぶっかけ・ルー攻め派
哀川 明慶	ぶっかけ・混ぜ混ぜ派
松沢 隆博	奥ルー・混ぜ混ぜ派
堤 ひかり	ぶっかけ・別口派
藤木 さゆり	ぶっかけ・ルー攻め派
富岡 明慶	ぶっかけ・せき止め派
塩見 良介	ぶっかけ・ルー攻め派
平岡 裕司	ぶっかけ・混ぜ混ぜ派
田上 ヒロ	奥ルー・ルー攻め派
北川 建	右ルー・ルー攻め派
板垣 竜也	左ルー・せき止め派
草村 広司	ぶっかけ・ナン派
赤坂 彩	左ルー・ルー攻め派
天野 建	左ルー・ルー攻め派
長谷部 愛菜	右ルー・ルー攻め派
吉田 明日	ぶっかけ・せき止め派
佐川 大	手前ルー・せき止め派
前田 米蔵	右ルー・混ぜ混ぜ派
林 光	ぶっかけ・ルー攻め派
北山 麻由子	右ルー・混ぜ混ぜ派
古山 三省	左ルー・混ぜ混ぜ派
丸田 茜	ぶっかけ・別口派
川西 しぼり	ぶっかけ・せき止め派
市田 里穂	奥ルー・混ぜ混ぜ派
坂井 光	右ルー・せき止め派
波多野 栄一	左ルー・せき止め派
高嶋 詩織	ぶっかけ・せき止め派
恩田 和香	左ルー・ルー攻め派
上条 妃里	左ルー・別口派
川島 莉央	左ルー・ナン派
酒井 遥	左ルー・混ぜ混ぜ派
玉木 竜也	別盛り・ルー攻め派
大原 怜奈	ぶっかけ・混ぜ混ぜ派
成海 仁	奥ルー・ルー攻め派
阪本 小雁	ぶっかけ・ルー攻め派
牧瀬 惇	左ルー・混ぜ混ぜ派
長沢 さやか	ぶっかけ・別口派
三輪 朝陽	奥ルー・せき止め派
榊原 恵梨香	左ルー・混ぜ混ぜ派
小口 直人	左ルー・ルー攻め派
篠原 路子	ぶっかけ・混ぜ混ぜ派
藤村 将也	左ルー・混ぜ混ぜ派
安部 那奈	左ルー・ナン派
宮迫 みき	右ルー・混ぜ混ぜ派
木村 倫子	ぶっかけ・せき止め派
渋谷 研二	右ルー・ルー攻め派
石沢 南朋	左ルー・ルー攻め派
成田 栄一	左ルー・せき止め派
国分 陽子	左ルー・せき止め派
柴山 ジローラモ	ぶっかけ・ナン派
草村 圭	左ルー・ルー攻め派
高沢 育子	ぶっかけ・せき止め派
金田 彩	右ルー・混ぜ混ぜ派
綾瀬 隼士	ぶっかけ・せき止め派
黒沢 サンタマリア	左ルー・せき止め派
永瀬 鉄二	ぶっかけ・ナン派
梅本 勇	左ルー・せき止め派
合田 幸平	手前ルー・別口派
米沢 ひろ子	左ルー・混ぜ混ぜ派
大林 瞳	左ルー・混ぜ混ぜ派
小沼 育二	手前ルー・別口派
麻生 さゆり	手前ルー・ルー攻め派
立川 優一	ぶっかけ・せき止め派
西山 祐一	右ルー・せき止め派
松居 紗季	ぶっかけ・ルー攻め派
渡部 克実	左ルー・せき止め派
水崎 一	ぶっかけ・混ぜ混ぜ派
田辺 草太	ぶっかけ・別口派
小野田 麻由子	ぶっかけ・混ぜ混ぜ派
八木 丈雄	左ルー・別口派
三木 みあ	左ルー・せき止め派
今 光博	左ルー・ルー攻め派
渡部 広司	ぶっかけ・混ぜ混ぜ派
野沢 さんま	ぶっかけ・せき止め派
芦屋 隆	左ルー・別口派
堤 倫子	ぶっかけ・混ぜ混ぜ派
宮川 優	左ルー・混ぜ混ぜ派
風間 貴美子	ぶっかけ・混ぜ混ぜ派
小谷 なぎさ	奥ルー・せき止め派
森口 雅之	ぶっかけ・せき止め派
岡崎 憲一	左ルー・別口派
永山 努	ぶっかけ・ルー攻め派
下田 明日	ぶっかけ・ルー攻め派
小林 春樹	奥ルー・ルー攻め派
柴山 直人	奥ルー・別口派
村井 景子	別盛り・ルー攻め派
村木 敏和	手前ルー・別口派
川西 三郎	左ルー・ナン派
堀田 洋介	ぶっかけ・せき止め派
ともさか 恵麻	左ルー・せき止め派
氏家 優	右ルー・ナン派
小林 愛子	右ルー・せき止め派
阿部 孝太郎	ぶっかけ・せき止め派
本田 隆	左ルー・ルー攻め派
庄司 和久	奥ルー・せき止め派
塩谷 豊	ぶっかけ・せき止め派
川原 茂樹	右ルー・別口派
仲村 璃奈子	左ルー・せき止め派
田村 鉄洋	右ルー・混ぜ混ぜ派
辻 宏行	左ルー・せき止め派
大久保 研二	左ルー・せき止め派
米沢 明慶	ぶっかけ・混ぜ混ぜ派
平山 亮	左ルー・ルー攻め派
西岡 まなみ	左ルー・別口派
広末 未來	左ルー・せき止め派
布川 里穂	右ルー・ルー攻め派
波多野 茜	ぶっかけ・混ぜ混ぜ派
岩沢 恵梨香	左ルー・別口派
菊田 ヒカル	ぶっかけ・ルー攻め派
多田 翔子	左ルー・せき止め派
有田 小百合	右ルー・混ぜ混ぜ派
小木 隆	奥ルー・ルー攻め派
秋葉 公顕	左ルー・ルー攻め派
阪口 雅彦	左ルー・混ぜ混ぜ派
川本 しほり	ぶっかけ・せき止め派
飯塚 薫	左ルー・ナン派
近藤 ヒカル	奥ルー・せき止め派
山内 徹	ぶっかけ・せき止め派
岩佐 小雁	左ルー・混ぜ混ぜ派
小松 杏	右ルー・混ぜ混ぜ派
三船 公顕	ぶっかけ・ルー攻め派
植田 祐基	ぶっかけ・せき止め派
高瀬 真帆	別盛り・せき止め派
須藤 涼子	左ルー・ルー攻め派
松谷 サンタマリア	左ルー・せき止め派
橋爪 サンタマリア	左ルー・せき止め派
中山 洋介	左ルー・ルー攻め派
新垣 光洋	右ルー・ルー攻め派
宮脇 美里	奥ルー・混ぜ混ぜ派
金子 結衣	奥ルー・せき止め派
藤野 知世	奥ルー・ナン派
西岡 美佳	手前ルー・別口派
諏訪 知世	右ルー・混ぜ混ぜ派
宮本 一徳	ぶっかけ・ルー攻め派
天野 基祐	ぶっかけ・ルー攻め派
正木 建	奥ルー・せき止め派
羽田 きみまろ	奥ルー・せき止め派
若山 宏行	左ルー・せき止め派
宮崎 ひかり	奥ルー・ナン派
江口 竜也	左ルー・ナン派
今 奈央	左ルー・せき止め派
関根 真悠子	ぶっかけ・せき止め派
安 未來	左ルー・せき止め派
遠山 惇	右ルー・せき止め派
大後 大樹	手前ルー・混ぜ混ぜ派
勝地 愛	奥ルー・混ぜ混ぜ派
吹石 一恵	ぶっかけ・せき止め派
哀川 剛基	ぶっかけ・せき止め派
中島 一代	左ルー・せき止め派
中林 建	左ルー・せき止め派
山岸 美優	右ルー・混ぜ混ぜ派
邑野 まみ	左ルー・別口派
矢野 薫	左ルー・ルー攻め派
長沢 陽介	別盛り・ルー攻め派
浅見 璃奈子	奥ルー・せき止め派
荒木 輝信	ぶっかけ・別口派
満島 慢太郎	左ルー・混ぜ混ぜ派
井田 優	左ルー・ルー攻め派
岩永 そら	ぶっかけ・ルー攻め派
井口 璃奈子	左ルー・ルー攻め派
原田 宏	左ルー・別口派
西脇 莉緒	ぶっかけ・ルー攻め派
前田 菜々美	左ルー・ルー攻め派
森下 早紀	左ルー・ルー攻め派
福士 佑	左ルー・混ぜ混ぜ派
三上 花緑	奥ルー・せき止め派
畑 隼士	ぶっかけ・せき止め派
西谷 竜也	左ルー・混ぜ混ぜ派
西川 丈史	ぶっかけ・別口派
沢井 隼士	奥ルー・せき止め派
青柳 聡	左ルー・ルー攻め派
古山 裕司	奥ルー・せき止め派
井出 まなみ	手前ルー・せき止め派
山西 美幸	ぶっかけ・混ぜ混ぜ派
岸本 遥	手前ルー・混ぜ混ぜ派
塩谷 ひとみ	ぶっかけ・せき止め派
武藤 敏也	左ルー・せき止め派
宮坂 美菜	右ルー・せき止め派
田畑 あき	左ルー・別口派
川島 桃子	奥ルー・混ぜ混ぜ派
黒谷 季衣	左ルー・別口派
榊原 三省	左ルー・混ぜ混ぜ派
比嘉 博明	右ルー・ルー攻め派
金城 浩正	左ルー・ナン派
小林 雅彦	左ルー・ルー攻め派
高見 英嗣	ぶっかけ・混ぜ混ぜ派
中尾 詩織	ぶっかけ・混ぜ混ぜ派
田辺 めぐみ	ぶっかけ・ルー攻め派
劇団 あき	ぶっかけ・せき止め派
森山 大	左ルー・ルー攻め派
安永 将也	ぶっかけ・混ぜ混ぜ派
畑 さとみ	左ルー・混ぜ混ぜ派
三上 徹	手前ルー・せき止め派
宇田川 敏也	左ルー・混ぜ混ぜ派
堀内 文世	奥ルー・ルー攻め派
坂下 有起哉	左ルー・せき止め派
宇野 秀樹	ぶっかけ・混ぜ混ぜ派
板橋 文世	別盛り・別口派
熊沢 恵子	奥ルー・せき止め派
青柳 貴嶺	左ルー・混ぜ混ぜ派
寺本 未來	ぶっかけ・ナン派
武藤 あさみ	手前ルー・混ぜ混ぜ派
大和 明日	ぶっかけ・せき止め派
茂木 倫子	手前ルー・別口派
三谷 さんま	左ルー・せき止め派
小松 薫	ぶっかけ・混ぜ混ぜ派
大崎 裕司	ぶっかけ・別口派
川村 丈雄	左ルー・別口派
加藤 薫	左ルー・せき止め派
北条 徹	左ルー・せき止め派
風間 憲史	左ルー・混ぜ混ぜ派
河原 隼士	別盛り・ルー攻め派
津田 草太	右ルー・混ぜ混ぜ派
池畑 樹里	手前ルー・混ぜ混ぜ派
小島 礼子	別盛り・ルー攻め派
木内 隆	奥ルー・ルー攻め派
岡 明宏	ぶっかけ・混ぜ混ぜ派
木戸 隆博	右ルー・別口派
亀山 草太	ぶっかけ・せき止め派
木下 知世	奥ルー・ルー攻め派
前川 雅彦	ぶっかけ・せき止め派
川西 直人	左ルー・別口派
長井 隆	奥ルー・ルー攻め派
宇田川 祐基	手前ルー・ナン派
江口 菜摘	左ルー・せき止め派
北 美咲	ぶっかけ・ルー攻め派
田辺 蒼甫	手前ルー・混ぜ混ぜ派
高野 昴	左ルー・別口派
赤羽 桃子	右ルー・ナン派
渡部 亜希	左ルー・混ぜ混ぜ派
長田 研二	ぶっかけ・混ぜ混ぜ派
関谷 菜摘	左ルー・ルー攻め派
北野 広之	左ルー・せき止め派
古賀 ひとり	左ルー・ルー攻め派
鈴木 しほり	左ルー・せき止め派
中原 茜	奥ルー・混ぜ混ぜ派
浜野 翔太	ぶっかけ・せき止め派
金城 俊二	左ルー・混ぜ混ぜ派
浅見 聡	奥ルー・混ぜ混ぜ派
大高 ひとみ	左ルー・ナン派
桑田 耕司	奥ルー・せき止め派
梅沢 丈雄	左ルー・せき止め派
安斎 さゆり	ぶっかけ・混ぜ混ぜ派
安永 勝久	左ルー・ナン派
大沢 美菜	ぶっかけ・せき止め派
森山 広司	手前ルー・ルー攻め派
川越 莉央	ぶっかけ・せき止め派
高木 美咲	手前ルー・せき止め派
浜本 惇	左ルー・せき止め派
丹野 基祐	右ルー・混ぜ混ぜ派
水谷 陽介	ぶっかけ・せき止め派
六角 めぐみ	ぶっかけ・せき止め派
畠山 豊	奥ルー・混ぜ混ぜ派
佐野 祐基	ぶっかけ・別口派
大田 聡	右ルー・ルー攻め派
倉田 里穂	左ルー・混ぜ混ぜ派
佐々木 真一	別盛り・混ぜ混ぜ派
新井 小百合	右ルー・ルー攻め派
深沢 南朋	ぶっかけ・せき止め派
筒井 菊生	左ルー・ルー攻め派
牧田 耕司	ぶっかけ・せき止め派
池畑 友香	奥ルー・ルー攻め派
川上 ひろ子	左ルー・ルー攻め派
小田 徹	左ルー・ルー攻め派
深井 砂羽	ぶっかけ・ルー攻め派
菊地 充則	左ルー・ナン派
宮崎 染五郎	別盛り・せき止め派
深沢 小雁	別盛り・混ぜ混ぜ派
大場 景子	右ルー・ルー攻め派
余 里奈	ぶっかけ・せき止め派
小出 美優	左ルー・せき止め派
日高 花緑	左ルー・せき止め派
平塚 マサカズ	別盛り・せき止め派
小原 美和子	ぶっかけ・せき止め派
堀内 未來	左ルー・ナン派
岩淵 はじめ	右ルー・せき止め派
西岡 竜也	手前ルー・混ぜ混ぜ派
小幡 敦	ぶっかけ・ナン派
朝倉 文世	左ルー・せき止め派
木村 朝陽	ぶっかけ・ルー攻め派
熊倉 沙耶	ぶっかけ・混ぜ混ぜ派
松田 璃子	ぶっかけ・別口派
島袋 高史	左ルー・ルー攻め派
田尻 めぐみ	右ルー・ルー攻め派
渡部 一哉	右ルー・せき止め派
有田 そら	ぶっかけ・せき止め派
今田 亮介	ぶっかけ・混ぜ混ぜ派
安座間 拓郎	ぶっかけ・せき止め派
水川 三省	ぶっかけ・別口派
大木 ジローラモ	手前ルー・ルー攻め派
小谷 恵梨香	ぶっかけ・ルー攻め派
恩田 孝太郎	ぶっかけ・混ぜ混ぜ派
大沼 勇介	ぶっかけ・ルー攻め派
島津 公顕	手前ルー・別口派
三浦 弘也	左ルー・せき止め派
生瀬 花	ぶっかけ・せき止め派
増井 しほり	奥ルー・混ぜ混ぜ派
井村 ケンイチ	左ルー・せき止め派
藤野 希	左ルー・せき止め派
山口 優	ぶっかけ・ルー攻め派
加瀬 美和子	ぶっかけ・ルー攻め派
相田 美佐子	ぶっかけ・ナン派
平 惇	左ルー・ルー攻め派
黄川田 長利	左ルー・別口派
井田 美紀	左ルー・混ぜ混ぜ派
内田 祐一	ぶっかけ・せき止め派
日下 達士	左ルー・ルー攻め派
新谷 遥	ぶっかけ・せき止め派
大沢 茜	奥ルー・せき止め派
磯野 正義	ぶっかけ・ルー攻め派
篠田 薫	左ルー・混ぜ混ぜ派
福田 高史	手前ルー・せき止め派
水上 紗季	ぶっかけ・せき止め派
北 一徳	手前ルー・別口派
長島 だん吉	右ルー・ナン派
平沢 真一	ぶっかけ・混ぜ混ぜ派
福島 雅彦	奥ルー・ルー攻め派
牧 奈央	ぶっかけ・ルー攻め派
関谷 美帆	左ルー・ルー攻め派
尾形 真悠子	ぶっかけ・混ぜ混ぜ派
角 たかお	左ルー・ナン派
小峰 雅彦	ぶっかけ・ルー攻め派
細谷 由宇	ぶっかけ・せき止め派
臼井 昴	手前ルー・せき止め派
福島 蒼甫	左ルー・せき止め派
阪本 徹	奥ルー・せき止め派
岩佐 貴嶺	左ルー・ルー攻め派
志賀 佳乃	左ルー・別口派
竹中 綾女	左ルー・せき止め派
小幡 信吾	奥ルー・せき止め派
広川 フミヤ	奥ルー・せき止め派
千田 メイサ	奥ルー・せき止め派
須賀 淳子	左ルー・せき止め派
内村 まひる	奥ルー・ルー攻め派
川村 直人	右ルー・別口派
堀井 玲那	左ルー・せき止め派
杉本 良介	ぶっかけ・せき止め派
板橋 秀隆	ぶっかけ・せき止め派
武田 和香	右ルー・別口派
江口 悟志	奥ルー・ルー攻め派
前島 直人	左ルー・混ぜ混ぜ派
大島 一代	別盛り・ルー攻め派
井沢 彩華	別盛り・ルー攻め派
末永 しぼり	左ルー・せき止め派
中川 将也	手前ルー・せき止め派
大内 豊	奥ルー・せき止め派
宮崎 憲史	左ルー・ルー攻め派
石沢 竜也	左ルー・混ぜ混ぜ派
高畑 里奈	別盛り・ルー攻め派
鶴田 豊	ぶっかけ・ルー攻め派
浅見 みき	ぶっかけ・せき止め派
及川 真希	ぶっかけ・混ぜ混ぜ派
酒井 真一	ぶっかけ・ルー攻め派
塚田 那奈	ぶっかけ・ルー攻め派
磯村 季衣	左ルー・ルー攻め派
小松 菜摘	ぶっかけ・混ぜ混ぜ派
井本 美希	左ルー・ルー攻め派
滝田 進	別盛り・ルー攻め派
細野 はるみ	奥ルー・ルー攻め派
神崎 将也	左ルー・ルー攻め派
宇野 美紀	奥ルー・別口派
森井 恵梨香	ぶっかけ・混ぜ混ぜ派
高島 俊二	ぶっかけ・ルー攻め派
松岡 光	左ルー・混ぜ混ぜ派
中村 遥	左ルー・混ぜ混ぜ派
関 希	左ルー・せき止め派